# # # # # # # # # # # # # # # # # # # # # # # # # # # # # # # # # # # # # # # # # # # # # # # # # # # # # # # # # #
# * * * * * * * * * * * * * * * * * * * * * * * * * * * * * * * * * * * * * * * * * * * * * * * * * * * * * * * * #
# * # # # * # # # # # # # # # * # # # # # # # # # # # # # # # * # # # # # # # # * # # # * # # # # # * # # # # # * #
# @ # # # * # # # # # # # # # * # # # # # # # # # # # # # # # * # # # # # # # #   # # # * # # # # # * # # # # # @ #
# * * * * * # # # # # # # # # * * * * * * * * * * * * * * * * * * * * * * * * * * # # # * * * * * * * * * * * * * #
# # # # # * # # # * * * * * * * # # # # # # # * # # # # # # #   # # #     # # #   # # # * # # # # # # # * # # # # #
# # # # # * # # # * # # # # # * # # # # # # # * # # # # # # #   # #         # #   # # # * # # # # # # # * # # # # #
# # # # # * # # # * # # # # # * # #       # # * # #       # #   # # M M M M # #   # # # * # #       # # * # # # # #
# # # # # * # # # * * @ # # # * # #       # # * # #       # #   # # # # # # # #   # # # * # # # # # # # * # # # # #
# # # # # * # # # # # # # # # * # #       # # * # #       # #   # # # # # # # #   # # # * # # # * * * * * # # # # #
# # # # # * # # # # # # # # # * # # # # # # # * # # # # # # #                     # # # * # # # # # # # * # # # # #
# # # # # * # # # # # # # # # * # # # # # # # * # # # # # # #   # # # # # # # #   # # # * # # # # # # # * # # # # #
# * * * * * * * * * * * * * * * * * * * * * * * * * * * * * * * # # # # # # # # * * * * * * * * * * * * * * * * * #
# * # # # # * # # # # # # # # # # * # # * # # # # # # # # # # * * * * # # * * * * # # # # # # # # # * # # # # # * #
# * # # # # * # # # # # # # # # # * # # * # # # # # # # # # # * # # * # # * # # * # # # # # # # # # * # # # # # * #
# @ * * * * * * * * * * * * * * * * # # * * * * * * * * * * * * # # * P * * # # * * * * * * * * * * * * * * * * @ #
# # # # # # # # # # # # # # # # # # # # # # # # # # # # # # # # # # # # # # # # # # # # # # # # # # # # # # # # # #
