# # # # # # # # # #
# * * * * * * * * #
# * # #     # # * #
# * # M * *   # @ #
# * # # # # # # * #
# * # P       # * #
# * #   # #   # * #
# * #   # #   # * #
# * * * * * * * * #
# # # # # # # # # #
